10 10
K.K......T
XX...XX..X
X.G.......
X.......K.
..........
XX...G..K.
.K...X....
XX...X..K.
...K...S..
XX........
