10 10
K.K......T
XX...XX..X
X...K.....
XXXXXXX.K.
....XG....
XX..XGX.K.
.K..XXX...
XX...XX.K.
S..K......
XX...XX...
